R 1920 1080
C 156,247,124
F 163,  1  ,247

NO   ./textures/merlin.xpm
EA ./textures/karadoc.xpm
WE ./textures/perceval.xpm
SO ./textures/guenievre.xpm
S ./textures/arthur.xp


           111111111111111111
           100100000010000101
11111111111100010010002000001
10010020010000110001000001001
10111000011120020200000010001
10010100001100000111011110001      
11100011111011011100000211001
11000000000101211101100010201
1000200100210202011000011S001
10001000200000201001010000001
10022000110100111110001101001
10000001111100011110001100001
11111111111111111111111111111
